XXXX.R.XXXX....XXRXE..XXXXRR..XXXXX.XXRRRXX.....E.XXX
XXXX.R.XXXX....XXRX...XXXXRR.EXXXXX.XXRRRXX.......XCX
XXXX.R.XXXX...EXXRX...OXXXRR..OOOOO.XXRRRXX.E.....XXX
XXXX.LEXXXXE...OXLC...XXXXLRE.OXXXO.XXRRRXXE...E..XXX
X1XX.L.XXXX....XXLX.E.XPXCLL..OXCHX.XCLRLXX.......XXX
XXXXEL.XXXX.E..XCRX...XXXXRR..OOOOOEXXLLLXH..E....XXX
XXXX.R.XXCX....OXRX...XXXXRR..XXXXX.XXLRRXX...E...XXX
XXXX.R.XXXX..E.XXRX..EXXXXRR..XXXXX.XXRRRXX......EXXX