......................................................
......................................................
......................................................
....................................C.................
..............................########################
.............##.........##..#...........#...........#.
.............#...........#..............#...........#.
.........1...#...........#..............##.........##.
##############################........................
......................................................