XXXXRRR.X..XXR.X..E..XXXXXR...XXXXX.XXRRRXX.....E.XX
XXXXRRR.X..XXR.X.....XXXXXR..EXXXXX.XXRRRXX.......XX
XXXXRRR.X..XXR.X.E...OOOOOR...XXXXX.XXRRRXX.E.....XX
XXXXLRRECE.OXL.C.....XXXXOL.E.XXXXO.XXRRRXXE...E..XX
X1XXLRL.X..XXL.X...E.XPXCOL...XSOXX.XCLRLXX.......XX
XXXXLLL.X.EXCREX.....XXXXORE..XXXXOEXXLLLXH..E....XX
XXXXLLR.X..OXR.X.....XXXXXR...XXXXX.XXLRRXX...E...CX
XXXXRLR.X..XXR.XE...EXXXXXR...XXXXX.XXRRRXX......EXX