XXXX.R.R..R....XXRXE..XXXX.RR.XRX.X.XXR.RXX..R.E.XXX
XXXX.R.R..R....XXRX...XXXX.RREXRX.X.XXR.RXX..R...XXX
XXXX.L.L..L...EXXRX...OXXXERR.XRXEO.XXR.RXX..R...XXX
XXXC.LELE.LE...XXLC...XXXX.LR.XRX.C.XXRERXXE.RE..XXX
X1XX.R.L..L....XOLX.E.XPXC.LL.SLX.X.XCL.LXX..R...XXX
XXXXER.L..L.E..XHRX...XXXX.RR.XRX.OEXXL.LXH..L...XXX
XXXX.R.R.ER....XXRX...XXXX.RR.XRX.X.XXL.RXX..R...XCX
XXXX.R.R..R..E.XXRX..EXXXX.RR.XRX.X.XXR.RXX.ER..EXXX